##########
#P       #
#        #
#    M   #
#        #
#      # #
#        #
#   #    #
#       G#
##########